//MAP CONVERTED BY dmm2tgm.py THIS HEADER COMMENT PREVENTS RECONVERSION, DO NOT REMOVE
"a" = (
/turf/simulated/wall,
/area/template_noop)
"c" = (
/obj/structure/table/rack/shelf,
/obj/random/material/low_chance,
/obj/random/material/low_chance,
/obj/random/science/low_chance,
/turf/simulated/floor/industrial/blue_slates{
	icon_state = "black_large"
	},
/area/template_noop)
"d" = (
/obj/random/cluster/roaches/lower_chance,
/turf/simulated/floor/industrial/blue_slates{
	icon_state = "black_large"
	},
/area/template_noop)
"f" = (
/obj/structure/table/rack/shelf,
/obj/random/material/low_chance,
/obj/random/material/low_chance,
/obj/random/material,
/obj/random/science/low_chance,
/turf/simulated/floor/industrial/blue_slates{
	icon_state = "black_large1"
	},
/area/template_noop)
"p" = (
/obj/structure/table/rack/shelf,
/obj/random/material,
/obj/random/material,
/obj/random/science/low_chance,
/obj/random/science/low_chance,
/turf/simulated/floor/industrial/blue_slates{
	icon_state = "black_large3"
	},
/area/template_noop)
"q" = (
/obj/item/circuitboard/autolathe{
	pixel_y = 7;
	pixel_x = -6
	},
/obj/random/cluster/roaches,
/turf/simulated/floor/industrial/blue_slates{
	icon_state = "black_large2"
	},
/area/template_noop)
"r" = (
/obj/item/stack/cable_coil{
	amount = 7
	},
/turf/simulated/floor/industrial/blue_slates{
	icon_state = "black_large"
	},
/area/template_noop)
"x" = (
/obj/random/cluster/roaches/low_chance,
/turf/simulated/floor/industrial/blue_slates{
	icon_state = "black_large"
	},
/area/template_noop)
"B" = (
/obj/structure/table/rack/shelf,
/obj/random/material/low_chance,
/obj/random/material/low_chance,
/obj/random/material/low_chance,
/obj/random/science/low_chance,
/turf/simulated/floor/industrial/blue_slates{
	icon_state = "black_large"
	},
/area/template_noop)
"E" = (
/obj/random/cluster/roaches/lower_chance,
/turf/simulated/floor/industrial/blue_slates{
	icon_state = "black_large1"
	},
/area/template_noop)
"M" = (
/turf/simulated/floor/industrial/blue_slates{
	icon_state = "black_large"
	},
/area/template_noop)
"N" = (
/obj/structure/table/rack/shelf,
/obj/random/material/low_chance,
/obj/random/science/low_chance,
/turf/simulated/floor/industrial/blue_slates{
	icon_state = "black_large3"
	},
/area/template_noop)
"O" = (
/obj/random/cluster/roaches,
/turf/simulated/floor/industrial/blue_slates{
	icon_state = "black_large"
	},
/area/template_noop)
"R" = (
/mob/living/carbon/superior_animal/roach/fuhrer,
/turf/simulated/floor/industrial/blue_slates{
	icon_state = "black_large3"
	},
/area/template_noop)
"S" = (
/turf/simulated/floor/industrial/blue_slates{
	icon_state = "black_large3"
	},
/area/template_noop)
"T" = (
/obj/structure/table/rack/shelf,
/obj/random/material/low_chance,
/obj/random/science/low_chance,
/turf/simulated/floor/industrial/blue_slates{
	icon_state = "black_large"
	},
/area/template_noop)
"X" = (
/turf/simulated/floor/industrial/blue_slates{
	icon_state = "black_large2"
	},
/area/template_noop)
"Y" = (
/obj/machinery/constructable_frame/machine_frame,
/obj/random/lathe_disk/low_chance,
/obj/random/lathe_disk/low_chance,
/turf/simulated/floor/industrial/blue_slates{
	icon_state = "black_large_fixed"
	},
/area/template_noop)

(1,1,1) = {"
a
a
x
a
a
"}
(2,1,1) = {"
a
Y
R
f
a
"}
(3,1,1) = {"
d
r
q
p
S
"}
(4,1,1) = {"
a
c
E
X
O
"}
(5,1,1) = {"
a
N
M
B
T
"}
