//MAP CONVERTED BY dmm2tgm.py THIS HEADER COMMENT PREVENTS RECONVERSION, DO NOT REMOVE
"a" = (
/obj/structure/cable{
	d1 = 1;
	d2 = 2;
	icon_state = "1-2"
	},
/turf/simulated/wall,
/area/template_noop)
"b" = (
/obj/machinery/shower{
	dir = 8
	},
/obj/effect/decal/cleanable/dirt,
/obj/random/junk/low_chance,
/obj/structure/cable{
	d1 = 4;
	d2 = 8;
	icon_state = "4-8"
	},
/turf/simulated/floor/tiled/steel/techfloor_grid,
/area/template_noop)
"e" = (
/obj/machinery/shower{
	dir = 4
	},
/obj/effect/decal/cleanable/dirt,
/obj/effect/decal/cleanable/dirt,
/obj/effect/decal/cleanable/dirt,
/obj/structure/cable{
	d1 = 4;
	d2 = 8;
	icon_state = "4-8"
	},
/turf/simulated/floor/tiled/steel/techfloor_grid,
/area/template_noop)
"g" = (
/obj/machinery/light{
	dir = 1
	},
/obj/effect/decal/cleanable/dirt,
/obj/structure/cable,
/turf/simulated/floor/tiled/white/gray_perforated,
/area/template_noop)
"i" = (
/obj/machinery/shower{
	dir = 8
	},
/obj/effect/decal/cleanable/dirt,
/turf/simulated/floor/tiled/steel/techfloor_grid,
/area/template_noop)
"j" = (
/obj/machinery/light,
/obj/effect/decal/cleanable/dirt,
/obj/structure/cable{
	d2 = 2;
	icon_state = "0-2"
	},
/turf/simulated/floor/tiled/white/gray_perforated,
/area/template_noop)
"k" = (
/obj/structure/cable{
	d1 = 2;
	d2 = 4;
	icon_state = "2-4"
	},
/obj/structure/cable{
	d1 = 2;
	d2 = 8;
	icon_state = "2-8"
	},
/obj/structure/cable{
	d1 = 1;
	d2 = 8;
	icon_state = "1-8"
	},
/obj/structure/cable{
	d1 = 1;
	d2 = 4;
	icon_state = "1-4"
	},
/turf/simulated/wall,
/area/template_noop)
"n" = (
/obj/structure/table/rack,
/obj/item/towel,
/obj/item/towel,
/obj/item/towel,
/obj/effect/decal/cleanable/dirt,
/obj/random/gun_cheap/low_chance,
/turf/simulated/floor/tiled/white/gray_perforated,
/area/template_noop)
"q" = (
/obj/structure/table/rack,
/obj/item/towel,
/obj/effect/decal/cleanable/dirt,
/obj/random/toy/action_figure,
/turf/simulated/floor/tiled/white/gray_perforated,
/area/template_noop)
"r" = (
/obj/machinery/shower{
	dir = 4
	},
/obj/effect/decal/cleanable/dirt,
/obj/effect/decal/cleanable/dirt,
/obj/random/spider_trap_burrowing/low_chance,
/turf/simulated/floor/tiled/steel/techfloor_grid,
/area/template_noop)
"s" = (
/obj/structure/table/rack,
/obj/effect/decal/cleanable/dirt,
/obj/effect/decal/cleanable/dirt,
/obj/random/melee/low_chance,
/obj/random/melee/low_chance,
/turf/simulated/floor/tiled/white/gray_perforated,
/area/template_noop)
"t" = (
/obj/structure/table/rack/shelf,
/obj/item/soap,
/obj/item/soap/syndie,
/turf/simulated/floor/tiled/white/gray_perforated,
/area/template_noop)
"y" = (
/obj/machinery/shower{
	dir = 4
	},
/obj/effect/decal/cleanable/dirt,
/obj/effect/decal/cleanable/dirt,
/obj/random/junk/low_chance,
/turf/simulated/floor/tiled/steel/techfloor_grid,
/area/template_noop)
"I" = (
/obj/effect/decal/cleanable/dirt,
/obj/effect/decal/cleanable/dirt,
/turf/simulated/floor/tiled/white/gray_perforated,
/area/template_noop)
"N" = (
/obj/effect/decal/cleanable/dirt,
/turf/simulated/floor/tiled/white/gray_perforated,
/area/template_noop)
"P" = (
/obj/effect/decal/cleanable/dirt,
/obj/structure/cable{
	d2 = 4;
	icon_state = "0-4"
	},
/turf/simulated/floor/tiled/white/gray_perforated,
/area/template_noop)
"Q" = (
/obj/effect/decal/cleanable/dirt,
/obj/effect/decal/cleanable/dirt,
/obj/structure/cable{
	d2 = 8;
	icon_state = "0-8"
	},
/turf/simulated/floor/tiled/white/gray_perforated,
/area/template_noop)
"S" = (
/obj/effect/decal/cleanable/dirt,
/obj/random/junk/low_chance,
/turf/simulated/floor/tiled/white/gray_perforated,
/area/template_noop)
"T" = (
/obj/machinery/shower{
	dir = 8
	},
/obj/effect/decal/cleanable/dirt,
/obj/random/spider_trap_burrowing/low_chance,
/turf/simulated/floor/tiled/steel/techfloor_grid,
/area/template_noop)

(1,1,1) = {"
S
q
P
n
I
"}
(2,1,1) = {"
N
i
b
T
N
"}
(3,1,1) = {"
j
a
k
a
g
"}
(4,1,1) = {"
N
r
e
y
S
"}
(5,1,1) = {"
t
N
Q
s
I
"}
