//MAP CONVERTED BY dmm2tgm.py THIS HEADER COMMENT PREVENTS RECONVERSION, DO NOT REMOVE
"a" = (
/obj/random/mob/carp/low_chance,
/turf/simulated/floor/asteroid/grass/colonialjungle3,
/area/template_noop)
"d" = (
/obj/structure/flora/pottedplant/flower,
/turf/simulated/floor/asteroid/grass/colonialjungle1,
/area/template_noop)
"l" = (
/obj/random/mob/carp/low_chance,
/obj/structure/flora/ausbushes/ppflowers,
/turf/simulated/floor/asteroid/grass/colonialjungle3,
/area/template_noop)
"s" = (
/obj/random/mob/carp/low_chance,
/obj/structure/flora/ausbushes/ywflowers,
/turf/simulated/floor/asteroid/grass/colonialjungle2,
/area/template_noop)
"u" = (
/obj/random/flora/jungle_tree,
/obj/structure/invislight,
/turf/simulated/floor/asteroid/grass/colonialjungle4,
/area/template_noop)
"A" = (
/turf/simulated/floor/asteroid/grass/colonialjungle2,
/area/template_noop)
"D" = (
/obj/random/mob/carp/low_chance,
/obj/structure/flora/ausbushes/ywflowers,
/turf/simulated/floor/asteroid/grass/colonialjungle3,
/area/template_noop)
"I" = (
/obj/structure/flora/ausbushes/brflowers,
/obj/structure/flora/ausbushes/ywflowers,
/turf/simulated/floor/asteroid/grass/colonialjungle2,
/area/template_noop)
"R" = (
/turf/simulated/floor/asteroid/grass/colonialjungle1,
/area/template_noop)
"V" = (
/obj/structure/flora/ausbushes/brflowers,
/turf/simulated/floor/asteroid/grass/colonialjungle3,
/area/template_noop)

(1,1,1) = {"
A
d
R
A
R
"}
(2,1,1) = {"
R
D
l
V
d
"}
(3,1,1) = {"
A
I
u
l
A
"}
(4,1,1) = {"
R
a
V
s
R
"}
(5,1,1) = {"
R
d
R
A
R
"}
