//MAP CONVERTED BY dmm2tgm.py THIS HEADER COMMENT PREVENTS RECONVERSION, DO NOT REMOVE
"a" = (
/obj/effect/decal/cleanable/dirt,
/obj/effect/decal/cleanable/dirt,
/turf/simulated/floor/tiled/dark/cyancorner{
	icon_state = "techfloor"
	},
/area/template_noop)
"b" = (
/obj/effect/decal/cleanable/dirt,
/obj/structure/closet/crate/trashcart,
/turf/simulated/floor/tiled/dark/cyancorner{
	icon_state = "techfloor"
	},
/area/template_noop)
"c" = (
/obj/effect/decal/cleanable/dirt,
/obj/effect/decal/cleanable/dirt,
/obj/effect/decal/cleanable/dirt,
/obj/structure/table/rack/shelf,
/obj/random/cloth/belt/low_chance,
/obj/random/cloth/belt/low_chance,
/obj/random/cloth/suit/low_chance,
/turf/simulated/floor/tiled/dark/cyancorner{
	icon_state = "techfloor"
	},
/area/template_noop)
"d" = (
/obj/effect/decal/cleanable/dirt,
/obj/effect/decal/cleanable/dirt,
/obj/random/cluster/roaches,
/turf/simulated/floor/tiled/dark/cyancorner{
	icon_state = "techfloor"
	},
/area/template_noop)
"e" = (
/obj/effect/decal/cleanable/dirt,
/obj/effect/decal/cleanable/dirt,
/obj/structure/table/rack/shelf,
/obj/random/cigarettes,
/obj/random/cloth/helmet/low_chance,
/obj/random/cloth/suit/low_chance,
/turf/simulated/floor/tiled/dark/cyancorner{
	icon_state = "techfloor"
	},
/area/template_noop)
"h" = (
/obj/effect/decal/cleanable/dirt,
/obj/effect/decal/cleanable/dirt,
/obj/effect/decal/cleanable/dirt,
/obj/random/cluster/roaches,
/turf/simulated/floor/tiled/dark/cyancorner{
	icon_state = "techfloor"
	},
/area/template_noop)
"j" = (
/obj/effect/decal/cleanable/dirt,
/obj/effect/decal/cleanable/dirt,
/obj/effect/decal/cleanable/dirt,
/obj/structure/table/rack/shelf,
/obj/random/cloth/glasses/low_chance,
/obj/random/cloth/helmet/low_chance,
/obj/random/cloth/suit/low_chance,
/turf/simulated/floor/tiled/dark/cyancorner{
	icon_state = "techfloor"
	},
/area/template_noop)
"u" = (
/obj/effect/decal/cleanable/dirt,
/obj/effect/decal/cleanable/dirt,
/obj/effect/decal/cleanable/dirt,
/turf/simulated/floor/tiled/dark/cyancorner{
	icon_state = "techfloor"
	},
/area/template_noop)
"z" = (
/obj/effect/decal/cleanable/dirt,
/obj/effect/decal/cleanable/dirt,
/obj/effect/decal/cleanable/dirt,
/obj/structure/table/rack/shelf,
/obj/random/booze/low_chance,
/obj/random/cloth/gloves,
/obj/random/cloth/masks/low_chance,
/obj/random/cloth/suit/low_chance,
/turf/simulated/floor/tiled/dark/cyancorner{
	icon_state = "techfloor"
	},
/area/template_noop)
"N" = (
/obj/effect/decal/cleanable/dirt,
/obj/effect/decal/cleanable/dirt,
/obj/structure/table/rack/shelf,
/obj/random/cloth/gloves,
/turf/simulated/floor/tiled/dark/cyancorner{
	icon_state = "techfloor"
	},
/area/template_noop)
"Q" = (
/obj/effect/decal/cleanable/dirt,
/obj/effect/decal/cleanable/dirt,
/obj/structure/closet/crate/trashcart,
/turf/simulated/floor/tiled/dark/cyancorner{
	icon_state = "techfloor"
	},
/area/template_noop)
"S" = (
/obj/effect/decal/cleanable/dirt,
/turf/simulated/floor/tiled/dark/cyancorner{
	icon_state = "techfloor"
	},
/area/template_noop)
"Y" = (
/obj/effect/decal/cleanable/dirt,
/obj/random/cluster/roaches,
/turf/simulated/floor/tiled/dark/cyancorner{
	icon_state = "techfloor"
	},
/area/template_noop)
"Z" = (
/obj/effect/decal/cleanable/dirt,
/obj/effect/decal/cleanable/dirt,
/obj/effect/decal/cleanable/dirt,
/obj/structure/table/rack/shelf,
/obj/random/booze/low_chance,
/obj/random/cloth/holster/low_chance,
/turf/simulated/floor/tiled/dark/cyancorner{
	icon_state = "techfloor"
	},
/area/template_noop)

(1,1,1) = {"
Y
S
S
S
b
"}
(2,1,1) = {"
b
e
z
Z
Q
"}
(3,1,1) = {"
S
a
u
h
a
"}
(4,1,1) = {"
Y
N
j
c
d
"}
(5,1,1) = {"
S
a
a
a
S
"}
