//MAP CONVERTED BY dmm2tgm.py THIS HEADER COMMENT PREVENTS RECONVERSION, DO NOT REMOVE
"a" = (
/obj/item/bananapeel,
/obj/item/reagent_containers/food/snacks/sliceable/bananabread,
/obj/random/mob/voidwolf/low_chance,
/turf/simulated/floor/industrial/blue_slates{
	icon_state = "black_large3"
	},
/area/template_noop)
"b" = (
/obj/item/reagent_containers/glass/beaker/vial/vape/banana,
/obj/effect/decal/cleanable/blood,
/obj/item/seeds/bloodtomatoseed,
/turf/simulated/floor/industrial/blue_slates{
	icon_state = "black_large1"
	},
/area/template_noop)
"c" = (
/obj/random/mob/voidwolf/low_chance,
/turf/simulated/floor/industrial/blue_slates{
	icon_state = "black_large2"
	},
/area/template_noop)
"j" = (
/obj/effect/decal/cleanable/blood,
/turf/simulated/floor/industrial/blue_slates{
	icon_state = "black_large3"
	},
/area/template_noop)
"k" = (
/turf/simulated/floor/industrial/blue_slates{
	icon_state = "black_large"
	},
/area/template_noop)
"m" = (
/obj/random/mob/voidwolf/low_chance,
/turf/simulated/floor/industrial/blue_slates{
	icon_state = "black_large_fixed"
	},
/area/template_noop)
"n" = (
/obj/item/bananapeel,
/obj/item/seeds/bloodtomatoseed,
/turf/simulated/floor/industrial/blue_slates{
	icon_state = "black_large"
	},
/area/template_noop)
"q" = (
/obj/effect/decal/cleanable/blood,
/obj/item/seeds/bloodtomatoseed,
/turf/simulated/floor/industrial/blue_slates{
	icon_state = "black_large2"
	},
/area/template_noop)
"r" = (
/obj/item/reagent_containers/food/snacks/sliceable/bananabread,
/turf/simulated/floor/industrial/blue_slates{
	icon_state = "black_large1"
	},
/area/template_noop)
"t" = (
/obj/effect/decal/cleanable/blood,
/turf/simulated/floor/industrial/blue_slates{
	icon_state = "black_large"
	},
/area/template_noop)
"z" = (
/obj/item/bananapeel,
/obj/item/reagent_containers/food/snacks/sliceable/bananabread,
/turf/simulated/floor/industrial/blue_slates{
	icon_state = "black_large3"
	},
/area/template_noop)
"G" = (
/obj/item/bananapeel,
/turf/simulated/floor/industrial/blue_slates{
	icon_state = "black_large"
	},
/area/template_noop)
"J" = (
/turf/simulated/floor/industrial/blue_slates{
	icon_state = "black_large2"
	},
/area/template_noop)
"L" = (
/turf/simulated/floor/industrial/blue_slates{
	icon_state = "black_large1"
	},
/area/template_noop)
"M" = (
/obj/item/bananapeel,
/obj/effect/decal/cleanable/blood,
/turf/simulated/floor/industrial/blue_slates{
	icon_state = "black_large_fixed"
	},
/area/template_noop)
"T" = (
/turf/simulated/floor/industrial/blue_slates{
	icon_state = "black_large3"
	},
/area/template_noop)
"X" = (
/obj/effect/decal/cleanable/blood,
/obj/random/mob/voidwolf/low_chance,
/turf/simulated/floor/industrial/blue_slates{
	icon_state = "black_large_fixed"
	},
/area/template_noop)
"Z" = (
/obj/item/bananapeel,
/mob/living/simple_animal/hostile/retaliate/clown/banana,
/obj/effect/decal/cleanable/blood,
/turf/simulated/floor/industrial/blue_slates{
	icon_state = "black_large3"
	},
/area/template_noop)

(1,1,1) = {"
t
L
j
m
k
"}
(2,1,1) = {"
T
a
n
q
t
"}
(3,1,1) = {"
j
J
Z
z
J
"}
(4,1,1) = {"
J
b
r
X
M
"}
(5,1,1) = {"
T
c
t
G
J
"}
