//MAP CONVERTED BY dmm2tgm.py THIS HEADER COMMENT PREVENTS RECONVERSION, DO NOT REMOVE
"a" = (
/obj/random/junk/low_chance,
/turf/simulated/floor/industrial/blue_slates_long_fixed{
	icon_state = "blue_long1"
	},
/area/template_noop)
"f" = (
/turf/simulated/floor/industrial/blue_slates_long_fixed{
	icon_state = "blue_long5"
	},
/area/template_noop)
"g" = (
/obj/structure/table/rack/shelf,
/turf/simulated/floor/industrial/blue_slates_long_fixed,
/area/template_noop)
"n" = (
/turf/simulated/floor/industrial/blue_slates_long_fixed,
/area/template_noop)
"x" = (
/obj/random/traps/low_chance,
/turf/simulated/floor/industrial/blue_slates_long_fixed,
/area/template_noop)
"y" = (
/obj/random/junk/low_chance,
/turf/simulated/floor/industrial/blue_slates_long_fixed{
	icon_state = "blue_long3"
	},
/area/template_noop)
"M" = (
/turf/simulated/floor/industrial/blue_slates_long_fixed{
	icon_state = "blue_long2"
	},
/area/template_noop)
"N" = (
/obj/structure/table/rack/shelf,
/turf/simulated/floor/industrial/blue_slates_long_fixed{
	icon_state = "blue_long6"
	},
/area/template_noop)
"Z" = (
/turf/simulated/floor/industrial/blue_slates_long_fixed{
	icon_state = "blue_long0"
	},
/area/template_noop)

(1,1,1) = {"
y
f
a
"}
(2,1,1) = {"
M
x
Z
"}
(3,1,1) = {"
g
n
N
"}
