//MAP CONVERTED BY dmm2tgm.py THIS HEADER COMMENT PREVENTS RECONVERSION, DO NOT REMOVE
"a" = (
/turf/simulated/floor/industrial/blue_slates_long_fixed{
	icon_state = "blue_long0"
	},
/area/template_noop)
"f" = (
/turf/simulated/floor/industrial/blue_slates_long_fixed{
	icon_state = "blue_long6"
	},
/area/template_noop)
"s" = (
/turf/simulated/floor/industrial/blue_slates_long_fixed{
	icon_state = "blue_long5"
	},
/area/template_noop)
"u" = (
/obj/machinery/hivemind_machine/node,
/turf/simulated/floor/industrial/blue_slates_long_fixed{
	icon_state = "blue_long4"
	},
/area/template_noop)
"T" = (
/turf/simulated/floor/industrial/blue_slates_long_fixed{
	icon_state = "blue_long2"
	},
/area/template_noop)

(1,1,1) = {"
a
f
f
"}
(2,1,1) = {"
a
u
s
"}
(3,1,1) = {"
a
a
T
"}
