//MAP CONVERTED BY dmm2tgm.py THIS HEADER COMMENT PREVENTS RECONVERSION, DO NOT REMOVE
"a" = (
/obj/random/furniture/pottedplant,
/turf/simulated/floor/industrial/blue_slates_long_fixed,
/area/template_noop)
"b" = (
/obj/random/traps/low_chance,
/turf/simulated/floor/industrial/blue_slates_long_fixed{
	icon_state = "blue_long5"
	},
/area/template_noop)
"c" = (
/obj/structure/table/rack/shelf,
/turf/simulated/floor/industrial/blue_slates_long_fixed,
/area/template_noop)
"e" = (
/turf/simulated/floor/industrial/blue_slates_long_fixed{
	icon_state = "blue_long3"
	},
/area/template_noop)
"k" = (
/turf/simulated/floor/industrial/blue_slates_long_fixed{
	icon_state = "blue_long4"
	},
/area/template_noop)
"C" = (
/turf/simulated/floor/industrial/blue_slates_long_fixed{
	icon_state = "blue_long6"
	},
/area/template_noop)
"G" = (
/obj/structure/table/rack/shelf,
/turf/simulated/floor/industrial/blue_slates_long_fixed{
	icon_state = "blue_long6"
	},
/area/template_noop)
"R" = (
/turf/simulated/floor/industrial/blue_slates_long_fixed{
	icon_state = "blue_long1"
	},
/area/template_noop)
"V" = (
/obj/item/computer_hardware/hard_drive/portable/design/guns/cheap_guns,
/obj/structure/table/standard,
/obj/random/cigarettes,
/turf/simulated/floor/industrial/blue_slates_long_fixed,
/area/template_noop)

(1,1,1) = {"
c
e
V
"}
(2,1,1) = {"
k
C
R
"}
(3,1,1) = {"
G
b
a
"}
